learningObjectRepository=Repositório de objetos de aprendizagem
collectionsTree=Árvore de coleções
notifications=Notificações
welcome=Bemvindo
exit=Sair
user=Usuário
password=Senha
iForgotMyPassword=Esqueci minha senha
rememberMe=Lembrar dados
signIn=Registrar
userOrPasswordWrong=Usuário ou senha inválidos
lastIndexedLearningObjects=Última objetos de aprendizaje indexados  
objectsFound=Objetos encontrados
uploadedBy=Carregado por
uploadedDate=Data de carregamento
rating=Avaliação
metadataQuality=Qualidade Metadados
options=Opções
downloads=Downloads
seeMore=Ver mais
seeLess=Ver menos
select=Selecionar
labelOrderBy=Ordenar por
votes=Votos
ratedObject=Qualificar objeto
textRatedObject=Se você deseja adicionar um comentário junto com o vosso voto
contentsAnonymousComment=Deixar comentário anônimo
download=Download
export=Exportar
learningObject=Objeto de aprendizagem
from=Desde
country=País
graphPercent=Gráficos percentuais
amount=Quantidade
numberOfDownloads=Total descarga
days=días
always=Sempre
generalInformation=Informações Gerais
indexedObjects=Objetos indexados
registeredUsers=Usuários cadastrados
termsAndConditions=Termos e Condições
licensedUnderGPL=Licenciado sob GPL
changeCollection=Alterar coleção
edit=Editar
delete=Remover
completeness=Integralidade
consistence=Consistência
coherence=Coerência
notApply=Não aplicável
searchInRoap=Pesquisar na Roap
advancedSearch=Pesquisa Avançada
simpleSearch=Pesquisa Simples
searchOnlyInThisCollection=Busca apenas nesta coleção
next=Seguinte
previous=Anterior
next100=100 próximo
previous100=100 anterior
first=Primeiro
last=Último
label=Campo
operator=Operador
value=Valor
title2=Titulo
keywords=Palavras-chave
format2=Formato
search=Pesquisa
general=Geral
generalDes=Esta categoria abrange as informações gerais do objeto de aprendizagem
genearlIdentifierDes=Etiqueta de identificação exclusivo de acordo com um sistema de catalogação
lifeCycle=Ciclo de vida
lifeCycleDes=Esta categoria abrange informações relacionadas com a história e estado atual do objeto de aprendizagem, incluindo os atores (indivíduos ou organizações) que falaram
contribution=Contribuição
contributionDes=Quem, como e quando nos ajudou com os objectos de aprendizagem
identifier=Identifier
metaMetadata=Meta-Metadado
technical=Técnica
educational=Uso educacional
educationalDescription=Descrição uso educacional
rights=Dereitos
relation=Relação
annotation=Anotação
classification=Classificação
catalog=Catálogo
entry=Entrada
language=Linguagems
description=Descrição
coverage=Ámbito
structure=estrutura
structure1=atômica
structure2=coleção
structure3=na rede
structure4=hierárquica
structure5=lineal
aggregationLevel=nível de agregação
aggregationLevel1=1
aggregationLevel2=2
aggregationLevel3=3
aggregationLevel4=4
identifier=Identifier
version=Versão
status=Estado
role=Rol
role1=autor
role2=desconhecido
role3=iniciador
role4=terminador
role5=revisor
role6=editor
role7=designer gráfico
role8=desenvolvedor técnico
role9=provedor de conteúdo
role10=revisor técnico
role11=revisor educacional
role12=roteirista
role13=designer educacional
role14=Especialista no campo
entity=Entidade
date=Data
metadataSchema=Esquema de Metadados
size2=Tamanho
location2=Localização
requirements=Requisitos
composition=Composição
type=Tipo
name=Nome
lastName=Sobrenomes
minimumVersion=Versão mínima
maximumVersion=Versão máxima
installationRemarks=Diretrizes de Instalação
otherPlatformRequirements=Outros requisitos de plataforma
duration=Duração
interactivityType=Tipo de interatividade
learningResourceType=Tipo de recurso educacional
interactivityLevel=Nível de interactividade
semanticDensity=Densidade Semântica
intendedEndUserRole=Destinatário
context=Contexto
typicalAgeRange=Típica faixa etária
difficulty=dificuldade
typicalLearningTime=Tempo de aprendizado Típico
cost=Custo
copyrightAndOtherRestrictions=Direitos autorais e outras restrições
resource=Recurso
kind=Tipo
entity=Entidade
taxonomicRoute=Rota taxonômica
taxon=Taxón
purpose=Propósito
source=Fonte
textAunNoTieneComentarios=Este objeto de aprendizagem ainda não tem comentários
reportOA=Relatorio objeto
ubiety=Localização
selectCollection=Selecione uma coleção
selectSubcollection=Selecione uma das subcoleções
accept=Aceitar
cancel=Cancelar
titleAddOA=Adicionar um objeto de aprendizagem para esta coleção
file=Arquivo
lomMetadata=Metadados LOM
uploadFile=Carregar Arquivo
fileReferencing=Referenciando arquivo
enteringData=Insira os dados
XMLimport=Importar XML
terms1=Eu li e concordo com o
terms2=termos e condições
terms3=uso
id3=Id
help=Ajuda
partialSave=Salvar parcialmente
completelySave=Salvar completamente
save=Salvar
example=Exemplo
exampleGeneralTitle2=A vida e a obra de Leonardo da Vinci
exampleGeneralDescription=Neste vídeo apresenta uma visão geral da vida e da obra de Leonardo Da Vinci com ênfase em sua produção artística, em especial a Mona Lisa.
exampleGeneralKeywords=Mona Lisa
exampleGeneralLanguage=Espanhol
exampleGeneralCoverage=França do século XVI
exampleGeneralStructure=atômica
exampleGeneralAggregationLevel=1
exampleGeneralCatalog=ISB
exampleGeneralEntry=978-0-262-53305-8
helpGeneralTitle=Nome atribuído ao objeto de aprendizagem
helpGeneralDescription=Uma descrição textual de não mais do que 2.000 caracteres sobre o conteúdo do objeto de aprendizagem
helpGeneralKeyword=Palavra ou frase que descreve o tema que aborda o objeto de aprendizagem
helpGeneralLanguage=O idioma ou os idiomas em que está escrito o conteúdo do objeto de aprendizagem
helpGeneralCoverage=O tempo, a cultura, área geográfica ou região relacionada com o objeto de aprendizagem.
helpGeneralStructure=-Forma em que se organizou o objeto de aprendizagem -atômico: o objeto não pode ser quebrado (uma imagem) -coleção: um conjunto de objetos sem uma ligação explícita entre eles (um tablet com várias imagens) -na rede: Um conjunto de objetos relacionados, mas sem uma hierarquia específica entre eles (um arquivo compactado com várias imagens de aves) -hierárquicas: Um conjunto de objetos relacionados, mas sem uma hierarquia específica entre eles (um arquivo compactado com várias imagens de aves com base na família e sexo) -linear: Um conjunto de objetos com uma ordem específica (um arquivo compactado com várias imagens de aves em perigo de extinção, ordenados do maior para o menor com base na sua população estimada em 2008)
helpGeneralAggregationLevel=A granularidade de objetos de aprendizagem. -1: Um único objeto que representa um pedaço da informação (um diagrama) -2: uma coleção de vários objetos de nível 1 (uma classe) -3: uma coleção de vários objetos de nível 2 (o curso) -4: uma coleção de vários objetos de nível 3 (um programa acadêmico)
helpGeneralCatalog=O nome do sistema de catalogação
helpGeneralEntry=Valor do identificador dentro do sistema de catalogação
exampleLifeCycleVersion=1.0
exampleLifeCycleStatus=final
exampleLifeCycleRol=autor
exampleLifeCycleEntity=Pedro Pérez
exampleLifeCycleDate=2006-07-18
helpLifeCycleVersion=Versão atual do objeto de aprendizagem
helpLifeCycleStatus=Estado ou condição de desenvolvimento de objetos de aprendizagem
helpLifeCycleRol=Tipo de contribuição
helpLifeCycleEntity=Identificação ou o nome da pessoa ou organização
helpLifeCycleDate=Data de contribuição
exampleMetadataSchema=LOMv1.0
exampleMetadataLanguage=espanhol
exampleMetadataRol=validador
exampleMetadataEntity=María Márquez
exampleMetadataDate=2006-09-24
exampleMetadataCatalog=URI
exampleMetadataEntry=http://www.ieee.org/descriptions/1234
helpMetadataSchema=Nome e versão da especificação utilizada para metadados
helpMetadataLanguage=Língua em que estão escritos os metadados
helpMetadataRol=Tipo de contribuição
helpMetadataEntity=Identificação ou o nome da pessoa ou organização
helpMetadataDate=Data da contribuição
helpMetadataCatalog=O nome do sistema de catalogação dos metadados
helpMetadataEntry=Valor do identificador dentro do sistema de catalogação dos metadados
exampleTechnicalFormat=pdf
exampleTechnicalSize=4096
exampleTechnicalUbiety=http://www.mirepositorio.com/objeto001
exampleTechnicalType=OS
exampleTechnicalName=Windows
exampleTechnicalMinimumVersion=Win XP
exampleTechnicalMaximumVersion=Win 7
exampleTechnicalInstallationRemarks=Descompacte o arquivo .zip e abra o index.html em seu navegador
exampleTechnicalOtherPlatformRequirements=Recomendamos que você tenha uma placa de vídeo
exampleTechnicalDuration=PT2H25M
helpTechnicalFormat=Os tipos de arquivo ou (se você tiver vários componentes) do objeto de aprendizagem
helpTechnicalSize=Tamanho em bytes do arquivo
helpTechnicalUbiety=Localização Digital do arquivo
helpTechnicalType=Tipo de tecnologia (hardware ou software)
helpTechnicalName=Nome da tecnologia (hardware ou software)
helpTechnicalMinimumVersion=Versão mínima necessária
helpTechnicalMaximumVersion=Versão máxima necessária
helpTechnicalInstallationRemarks=Descrição de como instalar ou utilizar os objetos de aprendizagem
helpTechnicalOtherPlatformRequirements=Informações sobre outros requisitos de software ou hardware
helpTechnicalDuration=Tempo que se leva para reproduzir o objeto de aprendizagem em uma velocidade normal
exampleLearningResourceType=texto narrativo
exampleLearningInteractivityType=ativo
exampleLearningInteractivityLevel=medio
exampleLearningIntendedEndUserRole=aprendiz
exampleLearningContext=Ensino básico e/ou secundário
exampleLearningTypicalAgeRange=10-13 anos
exampleLearningDifficulty=média
exampleLearningTypicalLearningTime=PT3H45M
exampleLearningDescription=Este objeto pode ser utilizado para reforçar o conhecimento, mas não deve ser utilizado para a avaliação
exampleLearningLanguage=espanhol
exampleLearningSemanticDensity=baixa
helpLearningResourceType=Tipo específico de objeto de aprendizagem. O mesmo objeto pode ser de um único tipo (tabela) ou conter múltiplas (tabela + figura + texto narrativa)
helpLearningInteractivityType=Modo predominante de aprendizagem apoiada pelo objeto: -ativo: Também conhecido como 'aprender fazendo', refere-se a objetos suportados pelo conteúdo que induz o aluno a executar ações (simulação, questionário, exercícios) -exposição: Exposição: também conhecido como 'aprendizado passivo', refere-se a objetos suportados pelo conteúdo que induz o aluno a manter um certo conhecimento (ensaio, apresentação) -misto: isto se refere a objetos suportados pelo conteúdo que mistura os dois padrões anteriores
helpLearningInteractivityLevel=Interatividade neste contexto refere-se ao grau em que o aluno pode influenciar a aparência ou o comportamento do objeto de aprendizagem
helpLearningIntendedEndUserRole=Ou os usuários para os quais foi criado o objeto de aprendizado
helpLearningContext=O ambiente educacional ou nível de formação na utilização dos objetos de aprendizagem
helpLearningTypicalAgeRange=Idade cronológica do usuário-alvo, ou a idade do desenvolvimento intelectual, no caso em que esta é diferente da idade cronológica
helpLearningDifficulty=Este elemento descreve o nível de dificuldade dos objetos de aprendizagem, para o típico destinatário
helpLearningTypicalLearningTime=Tempo aproximado necessário para um destinatário imitar o típico na exploração do conteúdo dos objetos de aprendizagem
helpLearningDescription=Informações Educacionais, cognitivas, ou outro tipo de descrição sobre como usar os objetos de aprendizagem
helpLearningLanguage=Língua nativa típica do destinatário, independente do idioma que você está escrevendo o conteúdo do objeto propriamente dito. Por exemplo, em uma semán de alunos em Inglês de língua semântica, o valor do atributo Geral -> Idioma seria o inglês, enquanto que no presente caso (utilização para fins educativos -> Language) seria espanhol
helpLearningSemanticDensity=Tão comprimido que você irá encontrar as informações contidas no objeto. Quanto mais explícita é a informação, menor a densidade do objeto e vice-versa.
exampleRightsCost=não
exampleRightsCopyrightAndOtherRestrictions=não
exampleRightsDescription=O uso deste objeto de aprendizado só é permitido mediante uma doação de uma quantia igual ou superior a US$ 5 para a Amnistia Internacional
helpRightsCost=Determina a utilização do objeto mediante qualquer pagamento
helpRightsCopyrightAndOtherRestrictions=Determina se o uso do objeto enquanto ele está condicionado pelas leis de direitos autorais ou outras restrições
helpRightsDescription=Comentários sobre as condições específicas de utilização do objeto de aprendizagem
exampleRelationKind=é parte da
exampleRelationDescription=Vídeo clip da Mona Lisa tomadas a partir da página do Museu do Louvre
exampleRelationCatalog=URI
exampleRelationEntry=Entrada
helpRelationKind=Define a natureza da relação entre o objeto e/ou os descritos abaixo
helpRelationDescription=Descrição de no máximo 1000 caracteres, o objeto com o qual ele tem relação
helpRelationCatalog=O nome do sistema de catalogação
helpRelationEntry=Valor do identificador dentro do sistema de catalogação
exampleAnnotationEntity=Juan Jiménez
exampleAnnotationDate=2005-07-13
exampleAnnotationDescription=Tenho utilizado este vídeo com os meus alunos de 8ª série  e estavam muito entusiasmados para aprender sobre a história da Mona Lisa
helpAnnotationEntity=Pessoa ou organização que realiza o comentário
helpAnnotationDate=Data a partir da qual foi feito o comentário
helpAnnotationDescription=Conteúdo do comentário
exampleClassificationPurpose=objetivo educacional
exampleClassificationDescription=Aprofundar a vida e a obra de artistas da Renascença
exampleClassificationKeywords=Italia
exampleClassificationSource=ACM
exampleClassificationId=4.1.2
exampleClassificationEntry=Belas Artes
helpClassificationPurpose=Para que você deseja classificar o objeto
helpClassificationDescription=Descrição do objeto em relação ao objetivo definido acima
helpClassificationKeywords=Palavras ou frases alusivas ao objeto em relação ao objetivo definido acima
helpClassificationSource=O nome do sistema de classificação
helpClassificationId=O identificador do táxon, como um número ou uma combinação de letras fornecidos pela fonte da taxonomia
helpClassificatioEntry=Etiqueta ou táxon
------------------------------------------=----------------------------------------------
metaMetadata=Metadados
colections=Coleções
users=Usuários
objectsReported=Objetos relatados
objectsDeleted=Objetos excluídos
languageSettings=Configurações de idioma
selectALanguage=Selecione o idioma
graphicOptions=As opções gráficas
colorPalette=Paleta de cores
customColors=Colores personalizadas
set=Estabelecer
mainBanner=Banner principal
defaultBanner=Banner Padrão
textNoteSetBanner=Nota: Se a imagem é menor que o tamanho da tela é será repetida horizontalmente
load=Carga
sendingMail=Envío de e-mails
serverSMTP=Servidor SMTP
port=Porto
sender=Remetente
email=E-mail
submit=Enviar
connectingToFRAC=Ligação com FROAC
textFroacConnection1=Você não está conectado ao FROAC
textFroacConnection2=Você está corretamente sincronizada com FROAC
connectingViaOAIPMH=Conexão via OAI-PMH
allowBeConsultedByOAIPMH=Permitir ser consultado por OAI-PMH
textRequiredFields=Por favor, selecione os campos que você deseja definir como obrigatório
addCollection=Adicionar Colecção
addSubcollection=Adicionar subcoleção
OAUploaded=OA carregado
userwhoReported=Usuário que informou 
deleteReport=Eliminar relatório
historical=História
reportingDate=Data do relatório
dateOfRevision=Data de Revisão
action=Ação
owner=Proprietário
deletedUser=O usuário que removeu
changeNames=Alterar nomes
changeLastName=Alterar apelido
changePassword=Alterar senha
verifyPassword=Verifique a senha
changeEmail=Alterar e-mail
registrationForm=Formulário de Inscrição
register=Registrar
resetPassword=Redefinição de senha
textResetPassword=Digite seu e-mail e nós lhe enviaremos um e-mail para redefinir sua senha
add=Adicionar
quit=Remover
seeOA=Ver OA
seeOAs=Ver OAs
grant=Concessão
deny=Negar
ok=OK
news=Notícias
requests=Pedidos
requestEditOA=pediu permissão para editar o OA
requestDeleteOA=pediu permissão para remover OA
requestChangeCollection=pediu permissão para alterar a coleção de OA
requestEditAccepted=concedeu-lhe permissão para editar a OA
requestDeleteAccepted=tiver sido concedida a permissão para a remoção OA
requestGrantAccepted=concedeu-lhe permissão para alterar a coleção da OA
requestEditDeny=ter sido negada a permissão para editar a OA
requestDeleteDeny=ter sido negada a permissão excluir para OA
requestGrantDeny=ter sido negada a permissão para alterar a coleção da OA
OASavedPartial=esta parcialmente salva
haveEditingPermission=Você tem permissão de edição sobre o ir
haveDeletingPermission=Você tem permissão do excluir permissão na OA
haveChangeCollectionPermission=Você tem permissão para alterar a coleção de OA
OAValored=tem valorizado a OA
textRecommendOA=Desde seu último acesso outros usuários enviou objetos para a coleção onde você contribui de forma mais geral
customRecommendedOA=Objetos de Aprendizado Recomendados
author=Autor
terms2=Condições e termos de uso 
terms3=Os termos gerais e condições estabelecidas abaixo regulam o uso do repositório de objetos de aprendizagem ROAp
terms4=O único uso do site dá a condição de utilizador do ROAP (doravante o "Usuário") e expressa a aceitação plena e sem reservas do usuário a todas e a cada uma dos Termos e Condições na versão publicada pela ROAP ao mesmo tempo o acesso do usuário. Como resultado, o usuário deve ler atentamente os Termos e Condições de cada uma das vezes em que ele pretende utilizar ROAP
terms5=Responsabilidade pela informação contida
terms6=ROAP não será responsável por quaisquer danos que possam ocorrer através do uso de informações fornecidas por meio do serviço
terms7=Porque meios técnicos disponíveis atualmente não garante a ausência absoluta de interferência pela ação de terceiros em sites publicados na Internet, ROAP não garante a exatidão e / ou veracidade de toda ou parte da informação contida no site, ou atualizá-lo, ou que essa informação tenha sido alterado ou modificado, no todo ou em parte, depois de ter sido colocado no site, ou qualquer outro aspecto ou característica da informação fornecida através do site ou através do eventualmente ligações incluídas nele
terms8=Em relação a esses programas, materiais ou informações que foi disponibilizado ao usuário para que ele possa baixá-los para seu computador, ou qualquer meio ou sistema de propriedade de suporte de memória ou cuja parada de posse ("materiais de download") de ROAP ou qualquer provedor de informações, ROAP não controla nem garante a ausência de vírus ou outros elementos nos conteúdos que possam produzir alterações em seu sistema informático (software e hardware) ou nos documentos eletrônicos e arquivos armazenados em seu sistema
terms9=ROAP exclui qualquer responsabilidade por danos de qualquer natureza que possam decorrer da presença de vírus ou a presença de outros elementos nos conteúdos que possam produzir alterações no sistema informático, documentos eletrônicos ou arquivos do usuário
terms10=Por esta razão, ROAP não é responsável por qualquer dano decorrente de qualquer alteração foi feita para os materiais
terms11=Privacidade das informações
terms12=A recolha e tratamento de dados pessoais tem como objetivo manter a boa fluido e da relação estabelecida entre o usuário eo ROAP, gestão, administração, prestação, ampliação e melhoramento dos serviços em que o usuário decide se inscrever, adequação de tais serviços às preferências e gostos dos usuários, o estudo da utilização dos serviços pelos usuários, o desenho de novos serviços relacionados a estes serviços, transporte, atualizações de serviço, transporte por meios tradicionais informação e eletrônica, técnico, operacional e comercial sobre os produtos e serviços oferecidos pela Colômbia aprende através do seu portal
terms13=Em particular, os dados ROAp só pode atribuir usuários a suas controladas e / ou sob o controle do Ministério da Educação
terms14=Propriedade intelectual
terms15=Conteúdo, todas as informações, mensagens, gráficos, desenhos, projetos, logotipos, nomes, marcas, arquivos de som e / ou imagens, fotografias, gravações, software e, em geral, qualquer tipo de material acessível através o ROAP
terms16=El usuario se obliga a
terms17=Utilizar os conteúdos de forma diligente, correcta e lícita
terms18=Não reproduzir, copiar, distribuir, alterar ou modificar os conteúdos, a menos que tenha permissão do detentor dos direitos autorais
terms19=Não remover, ignorar ou manipular o "copyright" e demais dados identificativos dos direitos dos ROAP ou seus proprietários incluídos no conteúdo, bem como os dispositivos técnicos de proteção, as identificações digitais ou qualquer dos mecanismos que podem conter informações conteúdo
terms20=Não use o conteúdo e, em particular, a informação de qualquer outro tipo obtida através Colômbia aprender ou serviços para a publicidade de transmissão
terms21=ROAp não será responsável pelo uso indevido ou pelo conteúdo que é enviado para o repositório
license1=Licencia GPL 
license2=Site distribuído sob a GNU General Public License, versão 2 ou posterior Código
license3=Este programa é software livre: você pode redistribuí-lo e / ou modificá-lo sob os termos da GNU General Public License conforme publicada pela Free Software Foundation, tanto a versão 2 da Licença, ou (a seu critério) qualquer versão posterior
license4=Este programa é distribuído na esperança que será útil, mas SEM GARANTIAS DE QUALQUER TIPO, nem mesmo a garantia implícita de COMERCIALIZAÇÃO ou ADEQUAÇÃO A UM DETERMINADO FIM. Para mais informações, veja a GNU General Public License
license5=Junto com este programa, você deve incluir uma cópia da GNU General Public License. Caso contrário, vá para
license6=http://www.gnu.org/licenses/