learningObjectRepository=Repositorio de objetos de aprendizaje
collectionsTree=Árbol de colecciones
notifications=Notificaciones
welcome=Benvenido
exit=Salir
user=Usuario
password=Contraseña
iForgotMyPassword=Olvidé mi contraseña
rememberMe=Recordar datos
signIn=Registrarse
userOrPasswordWrong=Usuario ó contraseña inválidos
lastIndexedLearningObjects=Últimos objetos de aprendizaje indexados
objectsFound=Objetos encontrados
uploadedBy=Subido por
uploadedDate=Fecha de subida
rating=Valoración
metadataQuality=Calidad de los metadatos
options=Opciones
downloads=Descargas
seeMore=Ver más
seeLess=Ver menos
select=Seleccionar
labelOrderBy=Ordenar por
votes=Votos
ratedObject=Calificar objeto
textRatedObject=Si desea agregue un comentario junto con su voto
contentsAnonymousComment=Contents anonymous comment
download=Descarga
export=Exportar
learningObject=Objeto de aprendizaje
from=Desde
country=País
graphPercent=Gráfica porcentual
amount=Cantidad
numberOfDownloads=Total descarga
days=días
always=Siempre
generalInformation=Infórmacion general
indexedObjects=Objetos indexados
registeredUsers=Usuarios registrados
termsAndConditions=Términos y condiciones
licensedUnderGPL=Licenciado bajo GPL
changeCollection=Cambiar de colección
edit=Editar
delete=Eliminar
completeness=Completitud
consistence=Consistencia
coherence=Coherencia
notApply=No aplica
searchInRoap=Buscar en ROAp
advancedSearch=Búsqueda avanzada
simpleSearch=Búsqueda simple
searchOnlyInThisCollection=Buscar únicamente en esta colección 
next=Siguiente
previous=Anterior
next100=100 siguientes
previous100=100 anteriores
first=Primero
last=Último
label=Campo
operator=Operador
value=Valor
title2=Titulo
keywords=Palabras clave
format2=Formato
search=Buscar
general=General
generalDes=Esta categoría cubre la información general del objeto de aprendizaje
genearlIdentifierDes=Etiqueta única de identificación según un sistema de catalogación
lifeCycle=Ciclo de vida
lifeCycleDes=Esta categoría cubre la información relacionada con la historia y estado actual del objeto de aprendizaje, incluyendo a los actores (personas u organizaciones) que han intervenido
contribution=Contribución
contributionDes=Quién, cómo y cuándo contribuyó con el objeto de aprendizaje
identifier=Identificador
metaMetadata=Meta-Metadata
technical=Técnica
educational=Uso educativo
educationalDescription=Descripción del uso educativo
rights=Derechos
relation=Relación
annotation=Anotación
classification=Clasificación
catalog=Catalogo
entry=Entrada
language=Idioma
description=Descripción
coverage=Ámbito
structure=Estructura
structure1=atómica
structure2=colección
structure3=en red
structure4=jerárquica
structure5=lineal
aggregationLevel=Nivel de agregación
aggregationLevel1=1
aggregationLevel2=2
aggregationLevel3=3
aggregationLevel4=4
identifier=Identificador
version=Versión
status=Estado
role=Rol
role1=autor
role2=desconocido
role3=iniciador
role4=terminador
role5=revisor
role6=editor
role7=diseñador gráfico
role8=desarrollador técnico
role9=proveedor de contenidos
role10=revisor técnico
role11=revisor educativo
role12=guionista
role13=diseñador educativo
role14=experto en la materia
entity=Entidad
date=Fecha
metadataSchema=Esquema de metadatos
size2=Tamaño
location2=Localización
requirements=Requisitos
composition=Composición
type=Tipo
name=Nombre
lastName=Apellidos
minimumVersion=Versión mínima
maximumVersion=Versión máxima
installationRemarks=Pautas de instalación
otherPlatformRequirements=Otros requisitos de plataforma
duration=Duración
interactivityType=Tipo de interactividad
learningResourceType=Tipo de recurso educativo
interactivityLevel=Nivel de interactividad
semanticDensity=Densidad semántica
intendedEndUserRole=Destinatario
context=Contexto
typicalAgeRange=Rango típico de edad
difficulty=Dificultad
typicalLearningTime=Tiempo típico de aprendizaje
cost=Coste
copyrightAndOtherRestrictions=Derechos de autor y otras restricciones
resource=Recurso
kind=Tipo
entity=Entidad
taxonomicRoute=Ruta taxónomica
taxon=Taxón
purpose=Propósito
source=Fuente
textAunNoTieneComentarios=Este obejeto de aprendizaje aún no tiene comentarios.
reportOA=Reportar objeto
ubiety=Ubicación
selectCollection=Seleccione una colección
selectSubcollection=Seleccione una subcolección
accept=Aceptar
cancel=Cancelar
titleAddOA=Agregar un objeto de aprendizaje a esta colección
file=Archivo
lomMetadata=Metadatos LOM
uploadFile=Subir archivo
fileReferencing=Referenciar archivo
enteringData=Ingresar datos
XMLimport=Importar XML
terms1=He leído y acepto los
terms2=términos y condiciones
terms3=de uso
id3=Id
help=Ayuda
partialSave=Guardar parcialmente
completelySave=Guardar completamente
save=Guardar
example=Ejemplo
exampleGeneralTitle2=La vida y obra de Leonardo da Vinci
exampleGeneralDescription=En este video se presenta brevemente la vida y obra de Leonardo Da Vinci haciendo énfasis en su producción artística, particularmente en la Mona Lisa
exampleGeneralKeywords=Mona Lisa
exampleGeneralLanguage=Español
exampleGeneralCoverage=Francia del siglo XVI
exampleGeneralStructure=atómica
exampleGeneralAggregationLevel=1
exampleGeneralCatalog=ISB
exampleGeneralEntry=978-0-262-53305-8
helpGeneralTitle=Nombre asignado al objeto de aprendizaje
helpGeneralDescription=Una descripción textual de no más de 2000 caracteres sobre el contenido del objeto de aprendizaje
helpGeneralKeyword=Palabra o frase que describe el tema que aborda el objeto de aprendizaje
helpGeneralLanguage=El idioma o los idiomas en los que se encuentra escrito el contenido del objeto de aprendizaje
helpGeneralCoverage=La época, cultura, zona geográfica o región relacionada al objeto de aprendizaje
helpGeneralStructure=Forma en la que está organizado el objeto de aprendizaje: atómica: el objeto no se puede dividir (una única imagen). Colección: un conjunto de objetos sin una relación explícita entre ellos (un comprimido con varias imágenes). En red: un conjunto de objetos relacionados pero sin una jerarquía específica entre ellos (un comprimido con varias imágenes de aves). Jerárquica: un conjunto de objetos relacionados pero sin una jerarquía específica entre ellos (un comprimido con varias imágenes de aves según familia y género). Lineal: un conjunto de objetos con un orden específico (un comprimido con varias imágenes de aves en peligro de extinción, ordenados de mayor a menor según su población estimada en 2008)
helpGeneralAggregationLevel=Granularidad del objeto de aprendizaje: 1: Un único objeto que representa un fragmento de información (un diagrama). 2: Una colección de varios objetos de nivel 1 (una clase). 3: Una colección de varios objetos de nivel 2 (un curso). 4: Una colección de varios objetos de nivel 3 (un programa académico)
helpGeneralCatalog=Nombre del sistema de catalogación
helpGeneralEntry=Valor del identificador dentro del sistema de catalogación
exampleLifeCycleVersion=1.0
exampleLifeCycleStatus=final
exampleLifeCycleRol=autor
exampleLifeCycleEntity=Pedro Pérez
exampleLifeCycleDate=2006-07-18
helpLifeCycleVersion=Versión actual del objeto de aprendizaje
helpLifeCycleStatus=Estado o condición de desarrollo del objeto de aprendizaje
helpLifeCycleRol=Tipo de contribución
helpLifeCycleEntity=Identificación o nombre de la persona u organización
helpLifeCycleDate=Fecha de la contribución
exampleMetadataSchema=LOMv1.0
exampleMetadataLanguage=español
exampleMetadataRol=validador
exampleMetadataEntity=María Márquez
exampleMetadataDate=2006-09-24
exampleMetadataCatalog=URI
exampleMetadataEntry=http://www.ieee.org/descriptions/1234
helpMetadataSchema=Nombre y versión de la especificación usada para los metadatos
helpMetadataLanguage=Idioma en que se encuentran escritos los metadatos
helpMetadataRol=Tipo de contribución
helpMetadataEntity=Identificación o nombre de la persona u organización
helpMetadataDate=Fecha de la contribución
helpMetadataCatalog=Nombre del sistema de catalogación para el metadato
helpMetadataEntry=Valor del identificador dentro del sistema de catalogación para el metadato
exampleTechnicalFormat=pdf
exampleTechnicalSize=4096
exampleTechnicalUbiety=http://www.mirepositorio.com/objeto001
exampleTechnicalType=sistema operativo
exampleTechnicalName=Windows
exampleTechnicalMinimumVersion=Win XP
exampleTechnicalMaximumVersion=Win 7
exampleTechnicalInstallationRemarks=Descomprima el .zip y abra el index.html en su navegador web
exampleTechnicalOtherPlatformRequirements=Se recomienda contar con tarjeta de video
exampleTechnicalDuration=PT2H25M
helpTechnicalFormat=El o los tipos de archivos (si tiene varios componentes) del objeto de aprendizaje
helpTechnicalSize=Tamaño en bytes del archivo
helpTechnicalUbiety=Localización digital donde se encuentra ubicado el archivo
helpTechnicalType=Tipo de la tecnología (hardware o software)
helpTechnicalName=Nombre de la tecnología (hardware o software)
helpTechnicalMinimumVersion=Versión mínima necesaria
helpTechnicalMaximumVersion=Versión máxima necesaria
helpTechnicalInstallationRemarks=Descripción de como instalar o usar el objeto de aprendizaje
helpTechnicalOtherPlatformRequirements=Información sobre otros requisitos de hardware o software
helpTechnicalDuration=Tiempo que demora en reproducirse el objeto de aprendizaje a una velocidad normal
exampleLearningResourceType=texto narrativo
exampleLearningInteractivityType=activo
exampleLearningInteractivityLevel=medio
exampleLearningIntendedEndUserRole=aprendiz
exampleLearningContext=escuela básica primaria y/o secundaria
exampleLearningTypicalAgeRange=10-13 años
exampleLearningDifficulty=media
exampleLearningTypicalLearningTime=PT3H45M
exampleLearningDescription=Este objeto puede usarse para reforzar conocimientos pero no debería usarse para evaluación
exampleLearningLanguage=español
exampleLearningSemanticDensity=baja
helpLearningResourceType=Tipo específico del objeto de aprendizaje. Un mismo objeto puede ser de un solo tipo (tabla) o contener varios (tabla + figura + texto narrativo)
helpLearningInteractivityType=Modo de aprendizaje predominante soportado por el objeto: activo: también conocido como “aprender haciendo”, se refiere a objetos soportados por contenido que induce al estudiante a realizar acciones (simulación, cuestionario, ejercicio) expositivo: expositivo: también conocido como “aprendizaje pasivo”, se refiere a objetos soportados por contenido que induce al estudiante a retener un determinado conocimiento (ensayo, presentación) mixto: mixto: se refiere a objetos soportados por contenido que mezclan las dos modalidades anteriores
helpLearningInteractivityLevel=Interactividad en este contexto se refiere al grado en el que el aprendiz puede influir en el aspecto o comportamiento del objeto de aprendizaje
helpLearningIntendedEndUserRole=El o los usuarios para los que ha sido diseñado el objeto de aprendizaje
helpLearningContext=El entorno educativo o nivel de formación en el que se utilizará el objeto de aprendizaje
helpLearningTypicalAgeRange=Edad cronológica del usuario objetivo, o edad de desarrollo intelectual, en caso de que ésta sea distinta de la edad cronológica
helpLearningDifficulty=Este elemento describe lo difícil que resulta, para los destinatarios típicos, utilizar el objeto de aprendizaje
helpLearningTypicalLearningTime=Tiempo aproximado que se necesita para que un destinatario típico asimile el contenido del objeto de aprendizaje
helpLearningDescription=Información pedagógica, cognitiva, didáctica o de otro tipo sobre como debe usarse el objeto de aprendizaje
helpLearningLanguage=Idioma materno del destinatario típico, independiente del idioma en el que esté escrito el contenido del objeto en sí. Por ejemplo en una clase de inglés para estudiantes hispano-hablantes, el valor del atributo General -> Idioma sería english, mientras que en este caso (Uso educativo -> Idioma) sería español
helpLearningSemanticDensity=Qué tan comprimida se encuentra la información contenida en el objeto. Mientra más explícita sea dicha información, menor será la densidad del objeto y viceversa
exampleRightsCost=no
exampleRightsCopyrightAndOtherRestrictions=no
exampleRightsDescription=El uso de este objeto de aprendizaje solo está permitido si se realiza una donación por un monto igual o superior a USD$5 a Amnistía Internacional
helpRightsCost=Determina si para usar el objeto mientras que se requiere efectuar algún pago
helpRightsCopyrightAndOtherRestrictions=Determina si el uso del objeto mientras que está condicionado por derechos de autor u otras restricciones
helpRightsDescription=Comentarios sobre las condiciones específicas de uso del objeto educativo
exampleRelationKind=es parte de
exampleRelationDescription=Clip de video de la Mona Lisa tomado de la página del Museo de Louvre
exampleRelationCatalog=URI
exampleRelationEntry=Entrada
helpRelationKind=Define la naturaleza de la relación entre el objeto y el o los descritos a continuació
helpRelationDescription=Descripción de máximo 1000 caracteres del objeto con el que tiene relación
helpRelationCatalog=Nombre del sistema de catalogación
helpRelationEntry=Valor del identificador dentro del sistema de catalogación
exampleAnnotationEntity=Juan Jiménez
exampleAnnotationDate=2005-07-13
exampleAnnotationDescription=He usado este video con mis estudiantes de grado 8 y se mostraron muy entusiasmados por conocer la historia de la Mona Lisa
helpAnnotationEntity=Persona u organización que realiza el comentario
helpAnnotationDate=Fecha en que realiza el comentario
helpAnnotationDescription=Contenido del comentario
exampleClassificationPurpose=objetivo educativo
exampleClassificationDescription=Profundizar en la vida y obra de artistas del renacimiento
exampleClassificationKeywords=Italia
exampleClassificationSource=ACM
exampleClassificationId=4.1.2
exampleClassificationEntry=Artes plásticas
helpClassificationPurpose=Para qué se desea clasificar el objeto
helpClassificationDescription=Descripción del objeto respecto al propósito anteriormente definido
helpClassificationKeywords=Palabras o frases alusivas al objeto respecto al propósito anteriormente definido
helpClassificationSource=Nombre del sistema de clasificación
helpClassificationId=El identificador del taxón, tal como un número o una combinación de letras proporcionadas por la fuente de la taxonomía
helpClassificatioEntry=Etiqueta del taxón
------------------------------------------=----------------------------------------------
metaMetadata=Metadatos
colections=Colecciones
users=Usuarios
objectsReported=Objetos reportados
objectsDeleted=Objetos eliminados
languageSettings=Configuración de idioma
selectALanguage=Seleccione un idioma
graphicOptions=Opciones gráficas
colorPalette=Paleta de colores
customColors=Colores personalizados
set=Establecer
mainBanner=Banner principal
defaultBanner=Banner por defecto
textNoteSetBanner=Nota: Si la imagen es menor que el tamaño de la pantalla esta se repetira horizontalmente
load=Cargar
sendingMail=Envío de correos
serverSMTP=Servidor SMTP
port=Puerto
sender=Remitente
email=Email
submit=Enviar
connectingToFRAC=Conexión con froac
textFroacConnection1=Usted no se encuentra conectado a FROAC
textFroacConnection2=Usted se encuentra correctamente sincronizado con FROAC
connectingViaOAIPMH=Conexión via OAI-PMH
allowBeConsultedByOAIPMH=Permitir ser consultado via OAI-PMH
textRequiredFields=Por favor marque los campos que desea establecer como obligatorios
addCollection=Agregar colección
addSubcollection=Agregar subcolección
OAUploaded=OA subidos
userwhoReported=Usuario que reportó
deleteReport=Eliminar reporte
historical=Historial
reportingDate=Fecha de reporte
dateOfRevision=Fecha de revisión
action=Acción
owner=Propietario
deletedUser=Usuario que lo eliminó
changeNames=Cambiar nombres
changeLastName=Cambiar apellidos
changePassword=Cambiar contraseña
verifyPassword=Verificar contraseña
changeEmail=Cambiar email
registrationForm=Formulario de registro
register=Registrarse
resetPassword=Reestablecer contraseña
textResetPassword=Ingrese su email y se le enviará un correo para reestablecer su contraseña
add=Añadir
quit=Eliminar
seeOA=Ver OA
seeOAs=Ver OAs
grant=Conceder
deny=Denegar
ok=OK
news=Novedades
requests=Solicitudes
requestEditOA=te ha solicitado permiso de edición para el OA
requestDeleteOA=te ha solicitado permiso de eliminación para el OA
requestChangeCollection=te ha solicitado permiso para cambiar la colección del OA
requestEditAccepted=te ha concedido permiso de edición para el OA
requestDeleteAccepted=te ha concedido permiso de eliminación para el OA
requestGrantAccepted=te ha concedido permiso para cambiar la colección del OA
requestEditDeny=te ha denegado permiso de edición para el OA
requestDeleteDeny=te ha denegado permiso de eliminación para el OA
requestGrantDeny=te ha denegado permiso para cambiar la colección del OA 
OASavedPartial=esta guardado parcialmente
haveEditingPermission=Tienes permiso de edición sobre el OA
haveDeletingPermission=Tienes permiso de eliminación sobre el OA
haveChangeCollectionPermission=Tienes permiso de para cambiar la colección del OA
OAValored=ha valorado el OA
textRecommendOA=Desde tu último acceso otros usuarios han subido objetos a la colección donde generalmente aportas más
customRecommendedOA=Objetos de aprendizaje recomendados
author=Autor
terms2=Condiciones y términos de uso
terms3=Los Términos y Condiciones generales que a continuación se establecen regulan el uso del repositorio de Objetos de Aprendizaje ROAp
terms4=La sola utilización del sitio atribuye la condición de usuario de ROAp (en adelante, el "Usuario") y expresa la aceptación plena y sin reservas del Usuario en todos y cada uno de los Términos y Condiciones en la versión publicada por ROAp en el momento mismo en que el usuario acceda. En consecuencia, el usuario debe leer atentamente los Términos y Condiciones en cada una de las ocasiones en que se proponga utilizar ROAp
terms5=Responsabilidad por la información contenida
terms6=ROAp no será responsable por los daños y perjuicios que pudieran ocasionarse mediante el uso de la información provista por medio del servicio
terms7=Debido a que en la actualidad los medios técnicos disponibles no permiten garantizar la absoluta falta de injerencia de la acción de terceras personas en los sitios publicados en Internet, ROAp de ninguna manera garantiza la exactitud y/o veracidad de todo o parte de la información contenida en el sitio, ni su actualización, ni que dicha información haya sido alterada o modificada en todo o en parte, luego de haber sido incluida en el sitio, ni cualquier otro aspecto o característica de la información brindada por medio del sitio o a través de los links eventualmente incluidos en el mismo
terms8=Respecto de aquellos programas, materiales o información que se haya puesto a disposición del usuario para que éste pueda descargarlos en su equipo, sistema o cualquier medio o soporte de memoria de su propiedad o cuya tenencia detente ("materiales de download") por parte de ROAp o cualquier proveedor de información, ROAp no controla ni garantiza la ausencia de virus ni de otros elementos en los contenidos que puedan producir alteraciones en su sistema informático (software y hardware) o en los documentos electrónicos y ficheros almacenados en su sistema
terms9=ROAp excluye cualquier responsabilidad por los daños y perjuicios de toda naturaleza que puedan deberse a la presencia de virus o a la presencia de otros elementos en los contenidos que puedan producir alteraciones en el sistema informático, documentos electrónicos o ficheros de los usuarios
terms10=Por lo mismo, ROAp no será responsable por ningún daño que se derive de cualquier alteración que se haya efectuado a los materiales
terms11=Privacidad de la información
terms12=La recolección y tratamiento automatizado de los datos personales tiene como finalidad el buen y fluido mantenimiento de la relación establecida entre el usuario y ROAp, la gestión, administración, prestación, ampliación y mejora de los servicios en los que el usuario decida suscribirse, la adecuación de dichos servicios a las preferencias y gustos de los usuarios, el estudio de la utilización de los servicios por parte de los usuarios, el diseño de nuevos servicios relacionados con dichos servicios, el envío; de actualizaciones de los servicios, el envío por medios tradicionales y electrónicos, de información técnica, operativa y comercial acerca de productos y servicios ofrecidos por Colombia Aprende a través de su portal
terms13=En particular, ROAp solamente podrá ceder los datos de los usuarios a las entidades dependientes y/o bajo el control del Ministerio de Educación
terms14=Propiedad intelectual
terms15=Se entenderá por contenidos a todas las informaciones, mensajes, gráficos, dibujos, diseños, logotipos, nombres, marcas, archivos de sonido y/o imagen, fotografías, grabaciones, software y, en general, cualquier clase de material accesible a través ROAp (en adelante los Contenidos)
terms16=El usuario se obliga a
terms17=Usar los contenidos de forma diligente, correcta y lícita
terms18=No reproducir, copiar, distribuir, transformar o modificar los contenidos a menos que se cuente con la autorización del titular de los correspondientes derechos
terms19=No suprimir, eludir, o manipular el "copyright" y demás datos identificatorios de los derechos de ROAp o de sus titulares incorporados a los contenidos, así como los dispositivos técnicos de protección, los identificadores digitales o cualesquiera sean los mecanismos de información que pudieran contener los contenidos
terms20=No emplear los contenidos y, en particular, la información de cualquier otra clase obtenida a través de Colombia Aprende o de los servicios para emitir publicidad.
terms21=ROAp no será responsable ni por el uso indebido ni por los contenidos que sean subidos al repositorio
license1=Licencia GPL
license2=Código del sitio web distribuído bajo la GNU General Public License, versión 2 o posterior. 
license3=Este programa es software libre: usted puede redistribuirlo y/o modificarlo conforme a los términos de la Licencia Pública General de GNU publicada por la Fundación para el Software Libre, ya sea la versión 2 de esta Licencia o (a su elección) cualquier versión posterior
license4=Este programa se distribuye con el deseo de que le resulte útil, pero SIN GARANTÍAS DE NINGÚN TIPO; ni siquiera con las garantías implícitas de COMERCIABILIDAD o APTITUD PARA UN PROPÓSITO DETERMINADO. Para más información, consulte la Licencia Pública General de GNU
license5=Junto con este programa, se debería incluir una copia de la Licencia Pública General de GNU. De no ser así, ingrese en
license6=http://www.gnu.org/licenses/